#############
#...@.......#
#...e..@....#
#.i.....e...#
#....i......#
#...........#
#############